SSTP_0000000200
SSTP_0000001000
SSTP_0000004800
SSTP_0000005600
SSTP_0000005800
SSTP_0000006300
SSTP_0000006900
SSTP_0000046600
SSTP_0000059400
SSTP_0000064900
SSTP_0000065000
SSTP_0000067100
SSTP_0000067200
SSTP_0000067400
SSTP_0000067500
SSTP_0000091800
SSTP_0000122200
SSTP_0000158200
SSTP_0000256800
SSTP_0000259600
SSTP_0000266900
SSTP_0000289133
SSTP_0000289200
SSTP_0000298400
SSTP_0000301100
SSTP_0000314000
SSTP_0000323700
SSTP_0000334100
SSTP_0000358500
SSTP_0000378200
SSTP_0000390600
SSTP_0000394400
SSTP_0000396200
SSTP_0000420700
SSTP_0000453200
SSTP_0000455200
SSTP_0000456300
SSTP_0000458700
SSTP_0000458800
SSTP_0000466200
SSTP_0000469300
SSTP_0000485600
SSTP_0000487700
SSTP_0000487800
SSTP_0000498800
SSTP_0000508500
SSTP_0000508700
SSTP_0000521600
SSTP_0000532300
SSTP_0000548100
SSTP_0000554000
SSTP_0000577000
SSTP_0000615800
SSTP_0000617600
SSTP_0000620100
SSTP_0000630300
SSTP_0000637300
SSTP_0000639100
SSTP_0000639200
SSTP_0000639400
SSTP_0000662900
SSTP_0000664900
SSTP_0000665200
SSTP_0000665800
SSTP_0000666200
SSTP_0000679900
SSTP_0000686200
SSTP_0000689100
SSTP_0000694300
SSTP_0000698800
SSTP_0000699200
SSTP_0000703700
SSTP_0000706100
SSTP_0000707600
SSTP_0000708200
SSTP_0000753000
SSTP_0000775700
SSTP_0000811400
SSTP_0000811500
SSTP_0000818100
SSTP_0000827600
SSTP_0000833900
SSTP_0000841200
SSTP_0000842300
SSTP_0000843400
SSTP_0000844700
SSTP_0000845400
SSTP_0000845600
SSTP_0000853900
SSTP_0000856800
SSTP_0000870100
SSTP_0000874500
SSTP_0000897100
SSTP_0000913900
SSTP_0000921500
SSTP_0000932500
SSTP_0000936900
SSTP_0000943100
SSTP_0000944000
SSTP_0000944200
SSTP_0000984100
SSTP_0000991100
SSTP_0001028900
SSTP_0001037300
SSTP_0001038000
SSTP_0001038200
SSTP_0001038300
SSTP_0001038800
SSTP_0001040000
SSTP_0001074500
SSTP_0001074800
SSTP_0001076200
SSTP_0001076500
SSTP_0001127900
SSTP_0001128200
SSTP_0001200600
SSTP_0001207700
SSTP_0001230400
SSTP_0001235100
SSTP_0001237400
SSTP_0001269700
SSTP_0001271000
SSTP_0001271100
SSTP_0001271200
SSTP_0001278000
